排名,国家/地区,金牌,银牌,铜牌,总数
1,挪威,16,8,13,37
2,德国,12,10,5,27
3,中国,9,4,2,15
4,美国,8,10,7,25
5,瑞典,8,5,5,18
6,荷兰,8,5,4,17
7,奥地利,7,7,4,18
8,瑞士,7,2,5,14
9,ROC,6,12,14,32
10,法国,5,7,2,14
11,加拿大,4,8,14,26
12,日本,3,6,9,18
13,意大利,2,7,8,17
14,韩国,2,5,2,9
15,斯洛文尼亚,2,3,2,7
16,芬兰,2,2,4,8
17,新西兰,2,1,0,3
18,澳大利亚,1,2,1,4
19,英国,1,1,0,2
20,匈牙利,1,0,2,3
21,比利时,1,0,1,2
21,捷克,1,0,1,2
21,斯洛伐克,1,0,1,2
24,白俄罗斯,0,2,0,2
25,西班牙,0,1,0,1
25,乌克兰,0,1,0,1
27,爱沙尼亚,0,0,1,1
27,拉脱维亚,0,0,1,1
27,波兰,0,0,1,1